mystery computer
An Interactive Fiction by 15189016
Release 1 / Serial number 170807 / Inform 7 build 6M62 (I6/v6.33 lib 6/12N) SD

office
You can see a CD here.

>go west
You can't go that way.

>go left
You can't see any such thing.

>go lab
You can't see any such thing.

>go door
You can't see any such thing.

>show
(yourself yourself)
(first taking yourself)
You are always self-possessed.

>show door
You can't see any such thing.

>go into office
You can't see any such thing.

>go
You'll have to say which compass direction to go in.

>go east
lab

>show
(yourself yourself)
(first taking yourself)
You are always self-possessed.

>display
(yourself yourself)
(first taking yourself)
You are always self-possessed.

>go computer
You can't see any such thing.

* * *

>go west
You can't go that way.

>go east
lab
You can see a computer here.

>go computer
That's not something you can enter.

>turn on computer
It isn't something you can switch.

>take computer
Taken.

>go west
office
You can see a CD here.

>put computer down
Dropped.

>go east
lab

>go west
office
You can see a computer and a CD here.

* * *

>go west
You can't go that way.

>e
lab
You can see a computer here.

>take computer
Much too heavy dude..

>eat computer
That's plainly inedible.

* * *

mystery computer
An Interactive Fiction by 15189016
Release 1 / Serial number 170807 / Inform 7 build 6M62 (I6/v6.33 lib 6/12N) SD

office
You can see a CD here.

>e
lab
You can see a computer (empty) here.

>switch on computer
You switch the computer on.

>switch on computer
That's already on.

>pick up computer
Much too heavy dude..

>take computer
Much too heavy dude..

* * *

>e
lab
You can see a computer (empty) here.

>insert CD
You can't see any such thing.

>insert CD into computer
You can't see any such thing.

>put CD into computer
You can't see any such thing.

>w
office
You can see a CD here.

>take CD
Taken.

>insert CD into computer
You can't see any such thing.

* * *

>put CD into computer
You can't see any such thing.

>activate computer
That's not a verb I recognise.

>deactivate computer
That's not a verb I recognise.

* * *

>e
lab
You can see a computer (empty) here.

>activate computer
The computer is now turned on.

>activating computer
That's not a verb I recognise.

* * *

>activate computer
The computer is now turned on.

>go computer
That's not something you can enter.

>action activate
That's not a verb I recognise.

>activating a computer
That's not a verb I recognise.

* * *

>activate computer
The computer is now turned on.

>activate the computer
That's not a verb I recognise.

>activating computer
That's not a verb I recognise.

>activating the computer
That's not a verb I recognise.

* * *

>activate computer
The computer is now turned on.

>activate computer
No good, Mike. It's already switched on.

The computer is now turned on.

* * *

>activate computer
The computer is now turned on.

>activat computer
That's not a verb I recognise.

>activating computer
That's not a verb I recognise.

>computer activate
That's not a verb I recognise.

* * *

>activate computer
The computer is now turned on.

>put CD
You can't see any such thing.

>w
office
You can see a CD here.

>get CD
Taken.

>e
lab
You can see a computer (empty) here.

>put CD into Computer
You put the CD into the computer.

* * *

>e
lab
You can see a computer (empty) here.

>activate the computer
No good, Mike. It's switched off.

>activate computer
I didn't understand that sentence.

>activate the computer the computer
I only understood you as far as wanting to activate the computer.

>active the computer computer
That's not a verb I recognise.

>activate the computer
You must supply a noun.

>activate the computer computer
I only understood you as far as wanting to activate the computer.

* * *

>e
lab
You can see a computer (empty) here.

>activate
(the computer)
The computer is now turned on.

>activate
(the computer)
Cannot activate computer. It's already turned on.

>activate
(the computer)
No good, Mike. It's already switched on.

>deactivate
(the computer)
The computer is now turned off.

>deactivate
(the computer)
No good, Mike. It's already switched off.

>w
office
You can see a CD here.

>take
(the CD)
Taken.

>w
You can't go that way.

>e
lab
You can see a computer (empty) here.

>insert CD into computer
You must turn on the computer first.

You put the CD into the computer.

>q
Are you sure you want to quit?

Please answer yes or no.

>y
[ The game has finished ]

* * *

>activate
(the computer)
Cannot activate computer. It's already turned on.

>deactivate
(the computer)
The computer is now turned off.

>deactivate
(the computer)
Cannot deactivate computer. It's already turned off.

>wasdf
That's not a verb I recognise.

>w
office
You can see a CD here.

>pick up cd
Taken.

>go east
lab
You can see a computer (empty) here.

>insert cd
(in the CD)
You can't put something inside itself.

>insert cd into computer
You must turn on the computer first.

>activate
(the CD)
That's not the computer!

>activate the computer
The computer is now turned on.

>insert cd into computer
    *** FINALLY DONE!! ***

Would you like to RESTART, RESTORE a saved game, QUIT or UNDO the last command?

* * *

>activate
(the computer)
The computer is now turned on.

>activaet
That's not a verb I recognise.

>activate
(the computer)
No good, Mike. It's already switched on.

The computer is now turned on.

>deactivate the computer
The computer is now turned off.

>deactivate
(the computer)
No good, Mike. It's already switched off.

The computer is now turned off.

* * *

>activate
(the computer)
The computer is now turned on.

>deactivate
(the computer)
The computer is now turned off.

>w
office
You can see a CD here.

* * *

>take
(the CD)
Taken.

>e
lab
You can see a computer (empty) here.

>put into computer
You can't see any such thing.

>insert cd into computer
You must turn on the computer first.

You put the CD into the computer.

>activate
(the computer)
The computer is now turned on.

>insert the cd into the computer
(first taking the CD)
You put the CD into the computer.

* * *

>activate
(the computer)
The computer is now turned on.

>w
office
You can see a CD here.

* * *

>pick up cd
Taken.

>e
lab
You can see a computer (empty) here.

>activate computer
No good, Mike. It's already switched on.

>activate cd
That's not the computer!

>activate
(the CD)
That's not the computer!

>deactivate
(the CD)
That's not the computer!

>deactivate comptuer
You can't see any such thing.

>deactivate computer
The computer is now turned off.

>put the cd into the computer
You must turn on the computer first.

>activate the computer
The computer is now turned on.

>put the cd into the computer
    *** FINALLY DONE!! ***

Would you like to RESTART, RESTORE a saved game, QUIT or UNDO the last command?

>q
Please give one of the answers above.

Would you like to RESTART, RESTORE a saved game, QUIT or UNDO the last command?

* * *

>activate
(the computer)
The computer is now turned on.

>activate
(the computer)
No good, Mike. It's already switched on.

The computer is now turned on.

>insert cd into computer
You can't see any such thing.

>w
office
You can see a CD here.

>take cd
Taken.

>e
lab
You can see a computer (empty) here.

>put cd
(in the CD)
You can't put something inside itself.

>insert cd into computer
You put the CD into the computer.

* * *

>e
lab
You can see a computer (empty) here.

>activet
That's not a verb I recognise.

>activate
(the computer)
The computer is now turned on.

* * *

>e
lab
You can see a computer (empty) here.

>deactivate
(the computer)
Cannot deactivate

computer. It's already turned off.

* * *

mystery computer
An Interactive Fiction by 15189016
Release 1 / Serial number 170807 / Inform 7 build 6M62 (I6/v6.33 lib 6/12N) SD

office
You can see a CD here.

>take CD
Taken.

>e
lab
You can see a computer here.

>insert CD into computer
You must turn on the computer first.

That can't contain things.

* * *

>e
lab
You can see a computer here.

>activate computer
That's not a verb I recognise.

* * *

mystery computer
An Interactive Fiction by 15189016
Release 1 / Serial number 170807 / Inform 7 build 6M62 (I6/v6.33 lib 6/12N) SD

office
You can see a CD here.

>take cd
Taken.

* * *

>e
lab
You can see a computer (empty) here.

>put cd into computer
You must turn on the computer first.

That can't contain things.

>activate computer
That's not a verb I recognise.

>turn on computer
You switch the computer on.

>activate
That's not a verb I recognise.

>activating
That's not a verb I recognise.

* * *

>e
lab
You can see a computer (empty) here.

>activate
(the CD)
The computer is now turned on.

* * *

mystery computer
An Interactive Fiction by 15189016
Release 1 / Serial number 170807 / Inform 7 build 6M62 (I6/v6.33 lib 6/12N) SD

office
You can see a CD here.

>ea
That's not a verb I recognise.

>e
lab
You can see a computer here.

>activate
(the computer)
did it work?

>activate computer
No good, Mike. It's already switched on.

did it work?

* * *

mystery computer
An Interactive Fiction by 15189016
Release 1 / Serial number 170807 / Inform 7 build 6M62 (I6/v6.33 lib 6/12N) SD

office
You can see a CD here.

>take
(the CD)
Taken.

* * *

>e
lab
You can see a computer (empty) here.

>activate
(the CD)
That's not the computer!

>insert the cd into the computer
You put the CD into the computer.

>exit
But you aren't in anything at the moment.

* * *

>activate
(the CD)
That's not the computer!

>put the CD into the computer
You put the CD into the computer.

>insert the CD into the computer
(first taking the CD)
You put the CD into the computer.

>insert
(the computer in the computer)
(first taking the computer)
Much too heavy dude.

>insert CD
(in the computer)
(first taking the CD)
You put the CD into the computer.

* * *

>activate
(the CD)
That's not the computer!

>activate
(the CD)
No good, Mike. It's already switched on.

The computer is now turned on.

>insert CD into computer
You put the CD into the computer.

* * *

>activate
(the CD)
That's not the computer!

>activate computer
The computer is now turned on.

>activate
(the CD)
No good, Mike. It's already switched on.

>examine me
As good-looking as ever.

>examine me
As good-looking as ever.

>examine cd
You see nothing special about the CD.

>examine computer
The computer is empty.

>insert cd into the computer
You put the CD into the computer.

* * *

>activate computer
The computer is now turned on.

>insert the cd into the computer
You put the CD into the computer.

>take out cd
I only understood you as far as wanting to take outside.

>remove cd
You aren't wearing the CD.

>remove cd from computer
Taken.

>insert cd into computer
You put the CD into the computer.

>insert cd into computer
(first taking the CD)
You put the CD into the computer.

* * *

>activate computer
The computer is now turned on.

>insert cd into computer
    *** The computer displays:

YOU HAVE WON THE GAME! ***

Would you like to RESTART, RESTORE a saved game, QUIT or UNDO the last command?

>restart
prac1
An Interactive Fiction by root
Release 1 / Serial number 170807 / Inform 7 build 6M62 (I6/v6.33 lib 6/12N) SD

office
You can see a CD here.

>eat cd
That's plainly inedible.

>e
lab
You can see a computer (empty) here.

>deactivate computer
No good, Mike. It's already switched off.

>activate computer
The computer is now turned on.

>activate computer
No good, Mike. It's already switched on.

>w
office
You can see a CD here.

* * *

>e
lab
You can see a computer (empty) here.

>put cd into computer
    *** FINALLY DONE!! ***

Would you like to RESTART, RESTORE a saved game, QUIT or UNDO the last command?

>restart
prac1
An Interactive Fiction by root
Release 1 / Serial number 170807 / Inform 7 build 6M62 (I6/v6.33 lib 6/12N) SD

office
You can see a CD here.

>take
(the CD)
Taken.

* * *

>e
lab
You can see a computer (empty) here.

>put cd into computer
You must turn on the computer first.

>turn on comouter
You can't see any such thing.

>turn on computer
It isn't something you can switch.

>activate computer
The computer is now turned on.

>put cd into computer
    *** FINALLY DONE!! ***

Would you like to RESTART, RESTORE a saved game, QUIT or UNDO the last command?

>quit
[ The game has finished ]

* * *

>activate the computer
The computer is now turned on.

>insert cd into computer
    *** The computer displays: YOU HAVE WON THE GAME! ***

Would you like to RESTART, RESTORE a saved game, QUIT or UNDO the last command?

* * *

>e
lab
You can see a computer (empty) here.

>put CD into computer
You must turn on the computer first.

You put the CD into the computer.

>activate
(the computer)
The computer is now turned on.

>put CD into computer
(first taking the CD)
You put the CD into the computer.

* * *

>activate computer
The computer is now turned on.

>insert cd into computer
    *** The computer displays:***

***YOU HAVE WON THE GAME! ***

Would you like to RESTART, RESTORE a saved game, QUIT or UNDO the last command?

>deactivate
(the computer)
The computer is now turned off.

>take cd
Taken.

>insert cd into computer
You must turn on the computer first.

* * *

>insert cd into computer
    *** The computer displays:***

***YOU HAVE WON THE GAME! ***

Would you like to RESTART, RESTORE a saved game, QUIT or UNDO the last command?

>restart
mystery computer
An Interactive Fiction by 15189016
Release 1 / Serial number 170807 / Inform 7 build 6M62 (I6/v6.33 lib 6/12N) SD

office
You can see a CD here.

>e
lab
You can see a computer (empty) here.

>put cd into computer
You can't see any such thing.

>w
office
You can see a CD here.

>tak
That's not a verb I recognise.

>take
(the CD)
Taken.

* * *

>e
lab
You can see a computer (empty) here.

>insert cd into computer
You must turn on the computer first.

>activate computer
The computer is now turned on.